R 2000 2000
NO ./texture/wall_3.xpm
SO ./texture/redbrick.xpm    
WE ./texture/wall_1.xpm          
EA ./texture/wall_2.xpm

S ./texture/pillar.xpm

C 210,20,50
F 10,220,53

111111111111111111111111111111111111      1111111111111111111111111111111111
100000000000000000000000000000000001      1000000000000000000000000000000001
100000000000000000000000000000000001      1000000000000000000000000000000001
1000000100001110000001111000000111111111111111000000111110000001111110000001
1000000100000000000000000000000000000000000000000000000000000000000000000011
100000010000000000000000000000000000001000000000000000000000000000000000001
100000011111100000001000000100000000001000000000000000000000000000000000001
100000011111100000000000000000000000001000000000011111111111111111111111111
100000010000000000000000000100000000001000000000011
100000011111110000001000000000000000001000000000011111111111111111111111111
1000000011111110000000000000000000000010000000000000000000000000000000000011111111111111
1000000001111111000000000010000000000010000000000000000000000000000000000000000000000001
1000000111111111000010000001000000000010000000000000000000000000000000000000000000000001
1000000100000000000000000000000000000010000000000000000000000000000000000011111111111111
100000010000000010000000000100000000000000000000000000000000000000000000001
100000000000000000001000000000000000001000002000200000000002000000020000001
100000000000000000000000000000000000001000000000000000000000000000000000001
100000011111111111111110001111111111111111111111111111001111111111111111111
100000010000000000000000000000000000001000000000000000000000000000000000001
100000010000000000000000000000000000000000000000000000000000000000000000001
111111010000000000000000000000000000001000000000000000000000000000000000001
     1000000000000000000N00000000000001000000000000000000000000000000000001
111111001000000000000000000000000000001000000000000000000000000000000000001
111110001000000000000000000000000000001000000000000000000000000000000000001
1000000000000000001111111111100000000010000000000000000110000000000000000111111
1111100100000000000111111111000000000010000000000000011  1100000000000000000001
10000001000000000000111111100000000000000000000000011     110000000000000000111
1000000100000000000001111100000000000000000000000011        11000000100000001
100000010000000000000011100000000000001000000000011          1100000101010101
1000000100000000000000010000000000000010000000000011        11000000101010101
10000001000000000000000000000000000000100000000000011      110000000101010101
1000000111111111111111000001111111111111110000000000011  11000000000101010101
1000000110000011000011000000000000011    100000000000001100000000000101010101
1000000000011000011000011000000000011    100000000000000000000000000101010101
1111111111111111111111111111110000011    111111111111111111111111111111111111
                             11111111