R 1200 900
NO ./texture/wall_1.xpm
SO ./texture/redbrick.xpm    
WE ./texture/wall_2.xpm          
EA ./texture/wall_3.xpm

S ./texture/pillar.xpm

C 100,200,150
F 10,112,112

11111111111111111111111111111111111111111111111111111111111111111111111111111111111111111111111111111
10000000000000000000001101000001110000010111000000000000000000000110000011100000000000000000000000011
11111111111111111111101101011011110111010111011111111111111111110110111011101111111111111111111111011
10100110000000000010101101011011110111010001011000001101111100010110121011101100110000000000000000011
10110110111111111000101101011011110111011101011011111101111101010110001011101110110111111111111111111
10110110111110111111101100011011110111011101011000000001111101010111011011101110110110000110000000001
10110110000000000000001111111011110111011101011011111100000001010110111011101110110110111110111011101
10110111111110111111100000000000000111011101011011110101111111010110111011101110110110111110111011101
10100000000000000000001111111111111111011001011000000101000000010110000011101110110110001110111011101
10111111111111111111111111111101111111011011011111111101111111110111111011101110110110101110111011101
10000000000000000000000000000000000000011011011100000000000000000000000011101110110110101110111011101
10111111111111111111111111111111111111011011011111111111111111111111111111101110110110101110111011101
10100000000000000000000000000000000001011000011100011000000000000000000000001110110111101110111011101
10111111111111111111111111111111111101011111011101111011111111111111111111111110110000001110111011101
10110011000011111000001110111100001101011111000000000000000000000000000000000000111111111110111011101
10110111011000001011100000000001101101011111011101111011111111111111111111111111111111111110111011101
10110111011110101011101111101111101101011101011101111011111000000000000000000000000000000000111011101
10110111011010101100000000101110101101011001000000000011111011111111111111111111111111111111111011101
10110000011010001111111111101110101101011011011111111011111010000010001000000000000010000001111011101
10110111011000100000000000001110101101011011000000000011111010111010101011111111111010111101111011101
10110001011110101111111111111110001101011000111111111011111010101010101011000000111010100000011011101
10111111011111111111111111111111111101011110111011100000111010101010101011011110111010101111011011101
10000000000000000000000000000000000001000000000000000N00000000001010101011011110111010101001011011101
11111111011111111111111111111111111011111111111011100000110111111010101011000000111010101011011011101
11011111011000000001111100011111111011110111111111111011000110000010101011011110111010101000011011101
10000011011111111101110001000111111011110000000000001011010110111110101011011110111010101111111011101
10110111000000000000110111110000111011110111111111101011110110111110111011000110111010100000000011101
10110111011111101111110111111110111011110111111111101010000000000000000011011010111010011111111011101
10111111011001101111000111110000111010000000000000001011111111101111111011011010111011111101111011101
10000000011011101111011111110111111011110111111111111011000000000000111011011010111000000000000000001
11110111011000001111011111110111111011110110000000001011111111101111111011011010111111111111111011101
10110111011111111111011100000000011011110110111110101000000000000000000011000010110000000000001010101
10000111000000000000011101111111011011110110000000110101111111101111111011111110110111111111111000101
10111111111111111111111101111111011011110111111111101011011011101111111000000000000000000000000010101
10010000000000000000000000000000000011110000000000011000000000000000000011110111111110111111011100101
11111111111111111111111111111111111111111111111111111111111111111111111111111111111111111111111111111