R 600 600

NO ./texture/wall_1.xpm
SO ./texture/redbrick.xpm    
WE ./texture/wall_2.xpm          
EA ./texture/wall_3.xpm

S ./texture/pillar.xpm

C 158, 158, 158
F 100, 120, 120

11111111111111111111111111111
10200000000000000000000000001
10000000000000000000000000001
10000200000000000000000000001
10000000000000000000000000001
10000000000000000000000000001
10000000000200000000000000001
10000000000000000000000000001
100000000000000002000000000011111111111111111111111111111111111111111111111111111111111111111111111111111111111
100000000000000000000000000000000000000000000000000000000000000000000000000000000000000000000000000000000000001
100000000000E00000000000000000000000000000000000000000000000000000000000000000000000000000000000000000000000201
100000000000000000000000000000000000000000000000000000000000000000000000000000000000000000000000000000000000001
100000000000000002000000000011111111111111111111111111111111111111111111111111111111111111111111111111111111111
10000000000000000000000000001
10000000000000000000000000001
10000000002000000000000000001
10000000000000000000000000001
10000000000000000000000000001
10020000000000000000000000001
10000000000000000000000000001
10000000000000000000000000001
10000000000000000000000002001
10000000000000000000000000001
10000000000000000000000000001
10000000000000000000000000001
10000000000000000000000000001
10000000000000000000000000001
10000000000000000000000000001
10000000000000000000000000001
10000000000000000000000000001
10000000000000000000000000001
11111111110000000000011111111
11111111111111000111111111111
11111111111111000111111111111
11111111111111000111111111111
11111111111111000111111111111
11111111111111000111111111111
11111111111111000111111111111
11111111111111000111111111111
11111111111111000111111111111
11111111111111000111111111111
11111111111111000111111111111
11111111111111000111111111111
11111111111111000111111111111
11111111111111000111111111111
11111111111111000111111111111
11111111111111000111111111111
11111111111111000111111111111
11111111111111020111111111111
11111111111111000111111111111
11111111111111111111111111111