R 640 600

C 200,100,50
F 100,11,12

11111111111111111111111111111
10200000000000000000000000001
10000000000000000000000000001
10000200000000000000000000001
10000000000000000000000000001
10000000000000000000000000001
10000000000200000000000000001
100000000000E0000000000000001
11111111111111111111111111111