R 1000 1000

NO ./texture/wall_1.xpm
SO ./texture/redbrick.xpm    
WE ./texture/wall_2.xpm          
EA ./texture/wall_3.xpm

S ./texture/pillar.xpm

C 250,250,250
F 0,0,125

11111111111111111111111111111
10000000000000000000000000001
10000000000000000000000000001
10000200000000000000000000001
10000000000000000000000000001
10000000000000000000000000001
10000000000200000000000000001
10000000000000000000000000001
10000000000000000200000000001
10000000000000000000000000001
10000000000000000000000000001
10000000000000000000000000001
10000000000000000000000200001
10000000000000000000000000001
10000000000000000000000000001
10000000002000000000000000001
10000000000000000000000000001
10000000000000000000000000001
10020000000000000000000000001
10000000000000000000000000001
10000000000000000000000000001
10000000000000000000E00002001
10000000000000000002000000001
11111111111111111111111111111